11111111111111111111111111111111111111111111111111111111111111
11111111111111111111111111111111111111111111111111111111111111
11111111111111111111111111111111111111111111111111111111111111
11111111111111111111111111111111111111111111111111111111111111
00000000000000000000000000000000000000000000000000000000000001
00000000000000000000000000000000000000000000000000000000000001
000800000000000000010004000000000080000K00000L00001000400000H1
09000AA0C00000000011000000066660000089AB0090000001100000006661
0000C000000006000001000060000000000000000000600000100006000001
1G00000K0000000L1001060000000000000000000000000100106000000001
11111111FFFFF11111111111111000011111111FFFFF111111111111111111